[[ 8 -1  4 -1 -1 -1 -1]
 [ 8  4  4 -1 -1 -1 -1]
 [ 8  7  7 -1 -1 -1 -1]
 [ 8  7  7 -1 -1 -1 -1]
 [-1  2  2  2 -1 -1 -1]
 [-1  1  2  2 -1 -1 -1]
 [-1  1  1  1 -1  6  6]
 [-1  1  3  5  6  6 -1]
 [ 3  3  3  5  6 -1 -1]
 [ 3  5  5  5 -1 -1 -1]]

[[ 8 -1  4 -1 -1 -1 -1]
 [ 8  4  4 -1 -1 -1 -1]
 [ 8  2  2 -1 -1 -1 -1]
 [ 8  2  2 -1 -1 -1 -1]
 [-1  2  7  7 -1 -1 -1]
 [-1  1  7  7 -1 -1 -1]
 [-1  1  1  1 -1  6  6]
 [-1  1  3  5  6  6 -1]
 [ 3  3  3  5  6 -1 -1]
 [ 3  5  5  5 -1 -1 -1]]

[[ 8 -1  2 -1 -1 -1 -1]
 [ 8  2  2 -1 -1 -1 -1]
 [ 8  2  2 -1 -1 -1 -1]
 [ 8  7  7 -1 -1 -1 -1]
 [-1  7  7  4 -1 -1 -1]
 [-1  1  4  4 -1 -1 -1]
 [-1  1  1  1 -1  6  6]
 [-1  1  3  5  6  6 -1]
 [ 3  3  3  5  6 -1 -1]
 [ 3  5  5  5 -1 -1 -1]]

[[ 8 -1  2 -1 -1 -1 -1]
 [ 8  2  2 -1 -1 -1 -1]
 [ 8  2  2 -1 -1 -1 -1]
 [ 8  7  7 -1 -1 -1 -1]
 [-1  7  7  1 -1 -1 -1]
 [-1  1  1  1 -1 -1 -1]
 [-1  4  4  1 -1  6  6]
 [-1  4  3  5  6  6 -1]
 [ 3  3  3  5  6 -1 -1]
 [ 3  5  5  5 -1 -1 -1]]

[[ 8 -1  2 -1 -1 -1 -1]
 [ 8  2  2 -1 -1 -1 -1]
 [ 8  2  2 -1 -1 -1 -1]
 [ 8  4  4 -1 -1 -1 -1]
 [-1  4  7  7 -1 -1 -1]
 [-1  1  7  7 -1 -1 -1]
 [-1  1  1  1 -1  6  6]
 [-1  1  3  5  6  6 -1]
 [ 3  3  3  5  6 -1 -1]
 [ 3  5  5  5 -1 -1 -1]]

[[ 5 -1  4 -1 -1 -1 -1]
 [ 5  4  4 -1 -1 -1 -1]
 [ 5  5  5 -1 -1 -1 -1]
 [ 2  2  2 -1 -1 -1 -1]
 [-1  2  2  1 -1 -1 -1]
 [-1  1  1  1 -1 -1 -1]
 [-1  3  3  1 -1  6  6]
 [-1  3  7  7  6  6 -1]
 [ 3  3  7  7  6 -1 -1]
 [ 8  8  8  8 -1 -1 -1]]

[[ 5 -1  4 -1 -1 -1 -1]
 [ 5  4  4 -1 -1 -1 -1]
 [ 5  5  5 -1 -1 -1 -1]
 [ 1  1  1 -1 -1 -1 -1]
 [-1  1  7  7 -1 -1 -1]
 [-1  1  7  7 -1 -1 -1]
 [-1  3  3  2 -1  6  6]
 [-1  3  2  2  6  6 -1]
 [ 3  3  2  2  6 -1 -1]
 [ 8  8  8  8 -1 -1 -1]]

[[ 5 -1  4 -1 -1 -1 -1]
 [ 5  4  4 -1 -1 -1 -1]
 [ 5  5  5 -1 -1 -1 -1]
 [ 1  1  1 -1 -1 -1 -1]
 [-1  1  2  2 -1 -1 -1]
 [-1  1  2  2 -1 -1 -1]
 [-1  3  3  2 -1  6  6]
 [-1  3  7  7  6  6 -1]
 [ 3  3  7  7  6 -1 -1]
 [ 8  8  8  8 -1 -1 -1]]

[[ 4 -1  5 -1 -1 -1 -1]
 [ 4  4  5 -1 -1 -1 -1]
 [ 5  5  5 -1 -1 -1 -1]
 [ 2  2  2 -1 -1 -1 -1]
 [-1  2  2  1 -1 -1 -1]
 [-1  1  1  1 -1 -1 -1]
 [-1  3  3  1 -1  6  6]
 [-1  3  7  7  6  6 -1]
 [ 3  3  7  7  6 -1 -1]
 [ 8  8  8  8 -1 -1 -1]]

[[ 4 -1  5 -1 -1 -1 -1]
 [ 4  4  5 -1 -1 -1 -1]
 [ 5  5  5 -1 -1 -1 -1]
 [ 1  1  1 -1 -1 -1 -1]
 [-1  1  7  7 -1 -1 -1]
 [-1  1  7  7 -1 -1 -1]
 [-1  3  3  2 -1  6  6]
 [-1  3  2  2  6  6 -1]
 [ 3  3  2  2  6 -1 -1]
 [ 8  8  8  8 -1 -1 -1]]

[[ 4 -1  5 -1 -1 -1 -1]
 [ 4  4  5 -1 -1 -1 -1]
 [ 5  5  5 -1 -1 -1 -1]
 [ 1  1  1 -1 -1 -1 -1]
 [-1  1  2  2 -1 -1 -1]
 [-1  1  2  2 -1 -1 -1]
 [-1  3  3  2 -1  6  6]
 [-1  3  7  7  6  6 -1]
 [ 3  3  7  7  6 -1 -1]
 [ 8  8  8  8 -1 -1 -1]]

[[ 4 -1  8 -1 -1 -1 -1]
 [ 4  4  8 -1 -1 -1 -1]
 [ 7  7  8 -1 -1 -1 -1]
 [ 7  7  8 -1 -1 -1 -1]
 [-1  2  2  2 -1 -1 -1]
 [-1  1  2  2 -1 -1 -1]
 [-1  1  1  1 -1  6  6]
 [-1  1  3  5  6  6 -1]
 [ 3  3  3  5  6 -1 -1]
 [ 3  5  5  5 -1 -1 -1]]

[[ 4 -1  8 -1 -1 -1 -1]
 [ 4  4  8 -1 -1 -1 -1]
 [ 2  2  8 -1 -1 -1 -1]
 [ 2  2  8 -1 -1 -1 -1]
 [-1  2  7  7 -1 -1 -1]
 [-1  1  7  7 -1 -1 -1]
 [-1  1  1  1 -1  6  6]
 [-1  1  3  5  6  6 -1]
 [ 3  3  3  5  6 -1 -1]
 [ 3  5  5  5 -1 -1 -1]]

[[ 2 -1  8 -1 -1 -1 -1]
 [ 2  2  8 -1 -1 -1 -1]
 [ 2  2  8 -1 -1 -1 -1]
 [ 4  4  8 -1 -1 -1 -1]
 [-1  4  7  7 -1 -1 -1]
 [-1  1  7  7 -1 -1 -1]
 [-1  1  1  1 -1  6  6]
 [-1  1  3  5  6  6 -1]
 [ 3  3  3  5  6 -1 -1]
 [ 3  5  5  5 -1 -1 -1]]

[[ 8 -1  4 -1 -1 -1 -1]
 [ 8  4  4 -1 -1 -1 -1]
 [ 8  7  7 -1 -1 -1 -1]
 [ 8  7  7 -1 -1 -1 -1]
 [-1  2  2  2 -1 -1 -1]
 [-1  1  2  2 -1 -1 -1]
 [-1  1  1  1 -1  6  6]
 [-1  1  3  5  6  6 -1]
 [ 3  3  3  5  6 -1 -1]
 [ 3  5  5  5 -1 -1 -1]]

[[ 8 -1  4 -1 -1 -1 -1]
 [ 8  4  4 -1 -1 -1 -1]
 [ 8  2  2 -1 -1 -1 -1]
 [ 8  2  2 -1 -1 -1 -1]
 [-1  2  7  7 -1 -1 -1]
 [-1  1  7  7 -1 -1 -1]
 [-1  1  1  1 -1  6  6]
 [-1  1  3  5  6  6 -1]
 [ 3  3  3  5  6 -1 -1]
 [ 3  5  5  5 -1 -1 -1]]

[[ 8 -1  2 -1 -1 -1 -1]
 [ 8  2  2 -1 -1 -1 -1]
 [ 8  2  2 -1 -1 -1 -1]
 [ 8  7  7 -1 -1 -1 -1]
 [-1  7  7  4 -1 -1 -1]
 [-1  1  4  4 -1 -1 -1]
 [-1  1  1  1 -1  6  6]
 [-1  1  3  5  6  6 -1]
 [ 3  3  3  5  6 -1 -1]
 [ 3  5  5  5 -1 -1 -1]]

[[ 8 -1  2 -1 -1 -1 -1]
 [ 8  2  2 -1 -1 -1 -1]
 [ 8  2  2 -1 -1 -1 -1]
 [ 8  7  7 -1 -1 -1 -1]
 [-1  7  7  1 -1 -1 -1]
 [-1  1  1  1 -1 -1 -1]
 [-1  4  4  1 -1  6  6]
 [-1  4  3  5  6  6 -1]
 [ 3  3  3  5  6 -1 -1]
 [ 3  5  5  5 -1 -1 -1]]

